+-++---+--
-+++++-+--
---++++---
+---++++-+
---++-+-++
-+-+-+--++
-+----+--+
+-++--++++
+-++++---+
----++++++